NO textures/bluestone.xpm
SO textures/mossy.xpm
WE textures/wood.xpm
EA textures/eagle.xpm

F 220,100,2
C 225,225,0


11111111111111111111
100000000000000000011111111111111111
100000000000000000000000000000000001
100000000111111111111111110000000001
100000000000000000000000000000000001
10000000000000E00001111111111111111111111
11111111111111111111
