   WE                            textures/wolfenstein/eagle.xpm
NO      textures/wolfenstein/bluestone.xpm



SO textures/wolfenstein/greystone.xpm

F      17,38,64

EA textures/wolfenstein/wood.xpm



C 218,234,235

1111111111111111111111111
10W0110000100001000000001
1000110000000000111111001
1000110000000000110001001
1000000000100000000001001
1111111111111111111111111
