NO Mandatory/textures/n.xpm
SO Mandatory/textures/s.xpm
WE Mandatory/textures/w.xpm
EA Mandatory/textures/e.xpm


F 220,100,2
C 225,30,0

11111111111111111111
100000000000000000011111111111111111
100000000000000000000000000000000001
1000000000W0000000011111111111111111
100000000000000000000000000000000001
100000000000000000011111111111111111
11111111111111111111
