        NO ./textures/NO.xpm
       WE         ./textures/WE.xpm          
EA ./textures/bricks.xpm
SO ./textures/SO.xpm


F 220,100,2
C 225,30,0

11111111111111111111
10000000000000000001
10000000000000000001
1000000000N000000001111111111
10000000000000000001
10000000000000000001
11111111111111111111