NO textures/matrix.xpm
SO textures/matrix.xpm
WE textures/matrix.xpm
EA textures/matrix.xpm



F 17,38,64
C 218,234,235


111111111111111111111
101000001000000000001
101010101011111110001
100010100010000010001
111110101111101011101
100000101000101000001
101111101011101111111
101000001010101000101
10101111101011 1110101111111
101010001010101010101
101110101010101010101
100000101010001010001
111111101011111011101
100000101000100010001
101110101110101110111
1010001000001000101011111111
101011111111111010101
1000100000000000100011111111
101010111011111111101
1N1000001000000000001
111111111111111111111