NO Mandatory/textures/bluestone.xpm
SO Mandatory/textures/mossy.xpm
WE Mandatory/textures/wood.xpm
EA Mandatory/textures/eagle.xpm


F 220,100,2
C 225,30,0

11111111111111111111
100000000000000000011111111111111111
100000000000000000000000000000000001
1000000000E0000000011111111111111111
100000000000000000000000000000000001
100000000000000000011111111111111111
11111111111111111111
