NO Mandatory/textures/001.xpm
SO Mandatory/textures/002.xpm
WE Mandatory/textures/003.xpm
EA Mandatory/textures/004.xpm



F 17,38,64
C 218,234,235


111111111111111111111
101000001000000000001
101010100100111110001
100010100010000010001
111110101111101011101
100000101000101000001
101111101011101111111
101000001010101000101
101011111010111110101
101010001010101010101
1011101010E0101010101
100000100110001010001
111111101001111011101
100000101000100010001
101110101110101110111
101000100000100010101
101011111111111010101
100010000000000010001
101010111011111111101
111000001000000000001
111111111111111111111